    _______________
   |  ___  |  ___  |
   | |   | | |   | |
   | |   | | |[*]| |
   | |___| | |___| |
   |       |       |
   |  []   |    [] |
   |_______|_______|
       <pool|locker>
