    _______________
   |  ___  |  ___  |
   | |   | | | * | |
   | |[ ]| | |[ ]| |
   | |___| | |___| |
   |       |       |
   |  []   |    [] |
   |_______|_______|
